@_______________________________@
|       ORDER ROOM CHOOSE       |
|-------------------------------|
|        {n}- New Order Room    |
|        {s}- Show Order Room   |
|        {b}- Back To Menu      |
@_______________________________@



